1111111111111111111111111111111111111111111111111111
1001000000001000000011111000000000001111000000000001
1P00011111000000000000A00C00001110000000001111000001
10001100000000000000001111110000000000011111111000E1
1111111111111111111111111111111111111111111111111111
